CARAMANLIS	PER.IND
NAIROBI	GPE.SPECIAL
HIS UNION	ORG.NGO
MR SIKHAKANE	PER.IND
ARAB	LOC
FRANCE	GPE.SPECIAL
LA NACION	ORG.COM
DEVELOPED COUNTRIES	LOC
NORTHERNER	GPE.SPECIAL
ALBANIA	GPE.NATION
OKINAWA	GPE.SPECIAL
THE MMM	ORG.NGO
YOUR	ORG.GOV
THE FACTORY	ORG.COM
THE ACCUSED	PER.IND
JSP	ORG.NGO
THE PRIME MINISTER 'S	PER.IND
SPRINGS	GPE.SPECIAL
MISSION LABOR ATTACHE	PER.IND
DEPARTMENT	ORG.GOV
AM	GPE.NATION
POPPER	PER.IND
YUGOSLAV	GPE.NATION
LEGAL COMMITTEE	ORG.MED
THAILAND	GPE.SPECIAL
GRAHAM	PER.IND
LONDON	GPE.SPECIAL
HAMA POULTRY INSTITUTION	ORG.GOV
UIL	ORG.NGO
THE THREE CONFEDERATIONS	PER.GROUP
THE STATION	NONE
I	PER.IND
BP	ORG.COM
RIYADH	GPE.SPECIAL
LESOTHO DEL	PER.IND
IAN SMITH	PER.IND
COMMERCE	ORG.GOV
HAMA	NONE
UNHCR 'S	ORG.MED
CU	ORG.NGO
PHNOM PENH	GPE.SPECIAL
SWEDISH	GPE.SPECIAL
AUSTRALIAN	GPE.NATION
NORDICS	LOC
URBAN ENVIRONMENT GROUP	ORG.MED
DUBS	PER.IND
THE ROKG	GPE.NATION
POST	ORG.GOV
MR. PRESIDENT	PER.IND
LEONARD	PER.IND
THE KELLOGG MANAGEMENT	ORG.COM
SHE	PER.IND
COUNTRY	GPE.SPECIAL
ALLON	PER.IND
CGIL	ORG.NGO
JAUERGUI	PER.IND
TURKISH	GPE.NATION
FONMIN	PER.IND
EC	ORG.GOV
SANA	GPE.SPECIAL
DR. WONG	PER.IND
BOTH COUNTRIES	LOC
VUCOVICH	PER.IND
AUCKLAND	GPE.SPECIAL
SILLEN	PER.IND
MUBARAK	PER.IND
NEB WORKERS '	PER.GROUP
SALISBURY	GPE.SPECIAL
THE SOVIET UNION	NONE
TEMPELHOF AIRPORT	LOC
AUSTRIAN	GPE.NATION
GREEKS	GPE.SPECIAL
AMBASSADOR	NONE
COMMISSION MEMBERS	PER.GROUP
BEIRUT	GPE.SPECIAL
GOPO	PER.IND
STATE	ORG.GOV
GENERAL HAIG	PER.IND
THE ECEVIT GOVERNMENT	GPE.NATION
GEPLACEA	ORG.COM
BRUSSELS	GPE.SPECIAL
OZOLINS	NONE
WEST BANK	LOC
BUCHAREST	ORG.GOV
CHARGE	PER.IND
HERSELF	PER.IND
POLISH LEADERS	GPE.NATION
KOCH	PER.IND
FORETAGEN AB	ORG.COM
FRG	GPE.NATION
AGENTS	PER.GROUP
WESTERN GROUP	ORG.MED
HE	PER.IND
LEBANESE	GPE.SPECIAL
RUSSIAN SERVICE	NONE
VOLPE	PER.IND
STOCKHOLM	GPE.SPECIAL
WORKING PARTY 8	PER.GROUP
THE UNITED NATIONS	ORG.MED
INGENIORSFIRMAN FLIESBERG AB	ORG.COM
KUWAIT	NONE
HIMSELF	NONE
FOREIGN MINISTER	NONE
BENIN	GPE.SPECIAL
UNGA	ORG.MED
NUSHI	PER.IND
CISL	ORG.NGO
THE TCC	ORG.MED
THE AMERICANS	GPE.NATION
PAKISTAN	GPE.SPECIAL
THE AMBASSADOR	NONE
MRS. STRAUSS	NONE
IT	GPE.NATION
LIKUD	ORG.NGO
THE CHINESE GOVERNMENT	GPE.NATION
SMI	NONE
THE PATRIOTIC FRONT	ORG.NGO
MFA OFFICIALS	NONE
GHANA	GPE.SPECIAL
MFA 'S	ORG.GOV
ROMANIANS	GPE.NATION
THIS PAPER	ORG.COM
RAMPHUL 'S	PER.IND
EMBOFFS	PER.GROUP
AMEMBASSY	ORG.GOV
ZIA 'S	PER.IND
MURPHY	PER.IND
BECKER	PER.IND
PASOK	NONE
U.K.	GPE.NATION
HOLST	PER.IND
USA	GPE.NATION
COUNCIL	NONE
CHAIRMAN 'S	ORG.MED
USG	GPE.NATION
MEANY	PER.IND
EMIGRANT	PER.GROUP
POLAND	GPE.SPECIAL
VLACHOU	PER.IND
COMMISSION	ORG.GOV
AMOCO 'S	ORG.COM
CITY	GPE.SPECIAL
KAMPUCHEA	GPE.SPECIAL
RIGA	GPE.SPECIAL
SOZACOM	NONE
LATIN AMERICA	LOC
THE ENVIRONMENT COMMITTEE	ORG.MED
AEROPERU	ORG.GOV
EURO - MPS	PER.GROUP
TRINIDAD	GPE.SPECIAL
ARMY	ORG.GOV
SITHOLE	NONE
YORUBA	PER.GROUP
GOVT	GPE.NATION
WEST	LOC
FRENCH	GPE.NATION
ELDIN	PER.IND
ITALIANS	GPE.NATION
VAROSHA	LOC
FRANGIE	PER.IND
TECHIMPORT	ORG.COM
SIKHAKANE	PER.IND
GENEVA	GPE.SPECIAL
ME	PER.IND
AZUCARERA CHOLUTECA	GPE.SPECIAL
ARMA	PER.IND
GREECE	GPE.SPECIAL
DOOKLEY 'S	PER.IND
MY	PER.IND
SOLDIERS	ORG.GOV
CZECHOSLOVAK	GPE.SPECIAL
NI	LOC
TOON	PER.IND
PRESIDENT EANES	PER.IND
EUROPEAN	LOC
KISSINGER	PER.IND
MFA	ORG.GOV
ERDA	ORG.GOV
AMBASSADOR LEONARD	PER.IND
LANE	PER.IND
GERMANY	GPE.NATION
PERMREP	PER.GROUP
SRV	NONE
PRESIDENTIAL	PER.IND
MOHAMMADZAI	PER.GROUP
PANAMA | |	GPE.SPECIAL
KARAME	PER.IND
RENE CRUZ	NONE
NORDLI	PER.IND
CUBAN	GPE.SPECIAL
LEBANON	GPE.SPECIAL
THE LIBYAN ARAB NAVY	ORG.GOV
USA REP	GPE.NATION
THEIR	LOC
THE UANC	ORG.NGO
MINISTER	NONE
SENATOR AND MCGREGOR	PER.GROUP
HABIBIE 'S	PER.IND
THE FON	PER.GROUP
AEROPERU 'S	ORG.GOV
BHUTTO	PER.IND
BELAYIM	LOC
THE BORDER	LOC
BRANIFF	ORG.COM
CHAO 'S	PER.IND
SHERRY	PER.IND
THE FPN	ORG.NGO
THE COMPANY	ORG.COM
THE STEERING COMMITTEE	ORG.MED
EGPC	ORG.GOV
AMMAN	GPE.SPECIAL
SUY	PER.IND
DEMIREL	PER.IND
RL	NONE
LAOS	GPE.NATION
SECRETARY GENERAL	PER.IND
CARACAS	GPE.SPECIAL
SENEGAL	GPE.NATION
ROLANDIS	PER.IND
ARAB WORLD	LOC
THE DICTATORSHIP	PER.IND
DEVELOPING COUNTRIES	LOC
THE NETHERLANDS	GPE.SPECIAL
SC	ORG.GOV
GROUP	PER.GROUP
DR. GOPO	PER.IND
INDIAN OCEAN	LOC
ACTING PRIME MINISTER	PER.IND
HUSSEIN	PER.IND
DAMASCUS	NONE
CCOP	ORG.NGO
PICORIUS	PER.IND
HUSBAND	PER.IND
KGB	ORG.GOV
GREEK CYPRIOTS	PER.GROUP
COMMITTEE	ORG.MED
ICE	ORG.GOV
THE CHINESE	GPE.NATION
BRITISH	GPE.NATION
VANCE	PER.IND
LATIN AMERICAN	LOC
PALESTINIAN	GPE.SPECIAL
THE SECRETARIAT	ORG.MED
PAN AM	NONE
UK	GPE.NATION
CUBANS	GPE.NATION
UN	ORG.MED
GJELSVIK	PER.IND
THE COURT	ORG.GOV
US	GPE.NATION
THE COMMUNISTS	ORG.NGO
NIGERIAN	GPE.NATION
SYRIANS	PER.GROUP
SYRIAN	GPE.NATION
IEA	NONE
LUTON AIRFIELD	LOC
TEL AVIV	ORG.GOV
MANSFIELD	PER.IND
THE COMMISSION	ORG.GOV
AMBASSADOR BROWN	PER.IND
SUEZ	LOC
CANADIAN	GPE.SPECIAL
THE COMMITTEE	ORG.MED
ECEVIT	PER.IND
SALZMAN	PER.IND
THE AFL - CIO	ORG.GOV
PAGO	GPE.SPECIAL
IRISH	NONE
HUSSEIN 'S	PER.IND
PRESIDENT 'S	PER.IND
THE DCM 'S	PER.IND
TAIWAN	GPE.SPECIAL
VIETNAM	GPE.SPECIAL
US MILITARY	ORG.GOV
HARUN	PER.IND
NEW DELHI	GPE.SPECIAL
WE	ORG.GOV
THE MILITARY	ORG.GOV
BONN	ORG.GOV
PERU	GPE.SPECIAL
BROWN	PER.IND
ETHIOPIAN	NONE
MFA CONSULAR DEPARTMENT	ORG.GOV
ASWAN	GPE.SPECIAL
THE UNITED STATES	GPE.SPECIAL
THE JOINT NATIONAL COUNCIL	ORG.GOV
GREEN	PER.IND
GREEK	GPE.NATION
PAPADOPOULOS	PER.IND
GUAYAQUIL	NONE
THE BISHOP	PER.IND
AGENCY	NONE
THE ORIT	ORG.GOV
THE SUPREME COMMANDER OF NATO	PER.IND
PRESIDENT	PER.IND
AMOCO	ORG.COM
VIETNAMESE	GPE.SPECIAL
BENIN 'S	GPE.NATION
NICARAGUAN	GPE.NATION
VP MUBARAK	PER.IND
ELEKDAG	PER.IND
MEDITERRANEAN	LOC
LOCAL	GPE.SPECIAL
RUDE PRAVO	ORG.NGO
UNCTAD	ORG.MED
THE COMMUNITY	ORG.MED
THE UN SECRETARIAT	ORG.MED
EACH COUNTRY	LOC
DOMESTIC	GPE.SPECIAL
THE ISRAELIS	GPE.NATION
OUR	GPE.NATION
EUROPE	LOC
IRAN	GPE.SPECIAL
MINNATPLAN	ORG.GOV
BRANIFF 'S	ORG.COM
HUNGARY	GPE.NATION
IRAQ	GPE.NATION
THE MFA	ORG.GOV
SWISS	GPE.SPECIAL
PORT MORESBY	NONE
ZOLA	PER.IND
SCOTT AIR FORCE BASE	LOC
SOVIETS	GPE.NATION
SOUTH AFRICA	GPE.SPECIAL
NATO	ORG.MED
IZMIR	NONE
BEGIN	PER.IND
DR. GLINSKI	PER.IND
CHAO	PER.IND
THE USA	GPE.NATION
TURKISH CYPRIOTS	PER.GROUP
RHODESIAN	GPE.SPECIAL
THE CHARGE	PER.IND
ROMANIA	GPE.SPECIAL
THE USG	GPE.NATION
THE PS	ORG.NGO
BOLIVIA	GPE.NATION
KUBISCH	PER.IND
PEZZANI	PER.IND
KOL	PER.IND
METRO MANILA	NONE
DAYAN	PER.IND
EMBASSY 'S	ORG.GOV
DAYAL	PER.IND
HAWAII	GPE.SPECIAL
WE )	ORG.NGO
KHMER	PER.GROUP
ILC	ORG.MED
WASHINGTON	GPE.SPECIAL
THE PRESIDENT - FOUNDER	PER.IND
BELGIUM	GPE.NATION
CHINESE	GPE.SPECIAL
FIELD OFFICE	ORG.GOV
CHIMOIO	LOC
ILP	ORG.NGO
THE PRESIDENT	PER.IND
THE ASSEMBLY	ORG.GOV
NEVADA	GPE.SPECIAL
NATION	GPE.SPECIAL
THE SECRETARIAT 'S	ORG.MED
IAEA	ORG.MED
PRESIDENT BANZER	PER.IND
FONMIN FACIO	PER.IND
THE FORMER SOZACOM DG	PER.IND
GILARDI	PER.IND
AFRICAN	LOC
BOTH	GPE.NATION
THE US	GPE.NATION
FINLAND	GPE.SPECIAL
THE UN	ORG.MED
CAB	ORG.GOV
THE UK	GPE.NATION
VIENNA	GPE.SPECIAL
LUSAKA	GPE.SPECIAL
ITSELF	GPE.NATION
GAJA	PER.IND
TCC	ORG.MED
PARLIAMENTARY	ORG.GOV
GREEK DEL	PER.IND
MR. SECRETARY GENERAL	PER.IND
VENIZELOS	PER.IND
THE ICFTU	NONE
ASAD	PER.IND
CHEN	PER.IND
ZANLA FORCES	ORG.NGO
THE MONARCHY	ORG.GOV
BENINESE	GPE.NATION
CCD	ORG.MED
DIEGO GARCIA	LOC
TEHRAN	GPE.SPECIAL
AFL - CIO	ORG.GOV
CCU	ORG.NGO
UNITY GOVERNMENT	ORG.NGO
PORTLAND	GPE.SPECIAL
QUIROS	PER.IND
NETHERLANDS	GPE.NATION
JAUERGUI 'S	PER.IND
PRIME MINISTER	PER.IND
PYONGYANG	GPE.NATION
COMMON FUND	ORG.MED
EXIMBANK	ORG.GOV
ECUADOR	GPE.NATION
LIBYAN	GPE.NATION
THE JP	ORG.NGO
UNDERHILL	PER.IND
MUELLER - THUNS	PER.IND
MIDDLE EAST	LOC
JERUSALEM	GPE.SPECIAL
POLICE	ORG.GOV
CHRISTIAN	PER.GROUP
CHROMALLOY	ORG.COM
THE UN 'S	ORG.MED
CODEL	PER.GROUP
SOUTH AFRICAN TROOPS	PER.GROUP
THE HCR	ORG.MED
CUBA	GPE.NATION
HOLMES	PER.IND
PAN AMERICAN	ORG.COM
WARSAW	GPE.SPECIAL
EMPLOYEES	PER.GROUP
CFA	ORG.MED
GPNG	NONE
GHASHMI	NONE
THE NORWEGIANS	GPE.NATION
WORLD BANK	ORG.MED
MELBOURNE	GPE.SPECIAL
COMMISSION 'S	ORG.GOV
GOA	GPE.NATION
ZAMBIA	GPE.SPECIAL
USDEL	ORG.GOV
GOC	GPE.NATION
GOB	GPE.NATION
CONGRESS	ORG.GOV
GOE	GPE.NATION
CONGEN	ORG.GOV
GOG	GPE.NATION
GOI	GPE.NATION
VELASQUEZ	PER.IND
GOK	GPE.NATION
GOJ	GPE.NATION
GOM	GPE.NATION
TRIPOLI	GPE.SPECIAL
THE GA	ORG.MED
INCB	ORG.MED
GON	GPE.NATION
GOP	GPE.NATION
HERMES	PER.IND
GOS	GPE.NATION
GOR	GPE.NATION
EMBOFF	PER.IND
THE PRG	ORG.NGO
FORLANI	PER.IND
THE EGYPTIANS	GPE.NATION
THE PRC	GPE.NATION
KENYA	GPE.NATION
FRANGIE 'S	PER.IND
GOVERNMENT	GPE.NATION
SYRIA	NONE
ADB	ORG.MED
HERMES '	PER.IND
EMBASSY	ORG.GOV
BISENGIMANA 'S	PER.IND
ADF	ORG.MED
USLO	NONE
CHINESE GOVERNMENT	GPE.NATION
ITS	GPE.NATION
CSAF	PER.IND
DOOKLEY	PER.IND
THE COUNTRY	GPE.SPECIAL
NORTHERN EUROPE	LOC
SYDNEY	GPE.SPECIAL
STARKIST	ORG.COM
HAVANA	GPE.SPECIAL
DANISH	GPE.NATION
AFRICA	LOC
OECD	ORG.MED
HUNGARIAN	GPE.NATION
NORTH	LOC
THE NSP	ORG.NGO
ICELANDIC	GPE.NATION
EMB	ORG.GOV
BANGKOK	ORG.GOV
DR. LI	PER.IND
THE DEPARTMENT 'S	ORG.GOV
SECRETARIAT	NONE
KAMEL	NONE
AUSTRALIA	GPE.NATION
HIS PARTY	ORG.NGO
GALINDO POHL	PER.IND
BOODHOO	PER.IND
ITALY	GPE.SPECIAL
PRESIDENT CARTER	PER.IND
CONGRESSIONAL	ORG.GOV
JAMAICA	GPE.SPECIAL
NIGERIA	GPE.NATION
THE MINISTRY	ORG.GOV
GUATEMALA	GPE.SPECIAL
SEATTLE	GPE.SPECIAL
AFD	ORG.GOV
DEFENSE	ORG.GOV
THE USA GOVERNMENT	GPE.NATION
CANADA	GPE.NATION
SECRETARY VANCE	PER.IND
CABINET	NONE
BOWDLER	PER.IND
KOREA	GPE.SPECIAL
HARTIG FLIESBERG	ORG.COM
UN TROOPS	PER.GROUP
NUGS	NONE
THE SOVIETS	GPE.NATION
SOVIET	GPE.NATION
SOCIALISM	PER.GROUP
CHAMOUN	PER.IND
CAIRO	GPE.SPECIAL
THE PRIME MINISTER	PER.IND
RUSSIAN	GPE.SPECIAL
NAC	ORG.MED
THE ETHIOPIANS	NONE
THE AEGEAN	LOC
GPRB	GPE.NATION
MAIER	PER.IND
FERNANDO NARANJO	PER.IND
NAM	ORG.GOV
HOME	GPE.SPECIAL
RL MANAGEMENT	NONE
DAVID SMITH	PER.IND
ASCOPE	ORG.NGO
PHILIPPINE	GPE.NATION
ISRAELIS	GPE.NATION
LEFTIST	PER.GROUP
THE DCM	PER.IND
AID	ORG.GOV
SPAIN	GPE.NATION
THE ATLANTIC	LOC
BULGARIA	GPE.NATION
BOTH PARTIES	PER.GROUP
NATIONAL	GPE.SPECIAL
THE PEOPLE 'S ASSEMBLY	ORG.GOV
WORKERS	PER.GROUP
HIS GOVERNMENT	GPE.NATION
GREECE 'S	NONE
INGERSOLL	PER.IND
LUNS	PER.IND
SARKIS	PER.IND
BORDER	LOC
PARLIAMENT	ORG.GOV
LABOR PARTY	ORG.NGO
MR. COPELAND	PER.IND
ICELAND	GPE.NATION
FISAFS	ORG.NGO
JARALLA	PER.IND
THE SECRETARY	PER.IND
NEVADA LEGISLATURE	ORG.GOV
NORTHERN SYRIA	LOC
PRETORIA	NONE
THE TWO GOVERNMENTS	LOC
INTRA - CEMA	ORG.MED
SECURITY PERSONNEL	PER.GROUP
WESTERN FIVE	LOC
COUNCIL OF MINISTERS	ORG.GOV
USSR	GPE.NATION
UNIVERSITY OF TENNESSEE	NONE
NEW YORK	GPE.SPECIAL
BETANCOURT	PER.IND
HONDURAN	GPE.SPECIAL
NICOSIA	ORG.GOV
NEB	NONE
NEA	NONE
HONDURAS	GPE.SPECIAL
PERU 'S	GPE.NATION
OVIR	ORG.GOV
ALC	ORG.GOV
LAO	GPE.SPECIAL
KABUL	GPE.SPECIAL
KOREAN	GPE.SPECIAL
FREEMAN	NONE
NOAA	NONE
WESTERN	NONE
NEW ZEALAND	GPE.NATION
THE BRITISH	GPE.NATION
GROUP OF EXPERTS	PER.GROUP
USUN	ORG.GOV
BAHR	PER.IND
THE CARAMANLIS GOVERNMENT	GPE.NATION
GAZA	LOC
MUZOREWA	PER.IND
SWAPO	ORG.NGO
UNHCR	ORG.MED
JUSTICE	ORG.GOV
ADMIRAL FOLEY	PER.IND
ROK	GPE.NATION
ALEPPO	NONE
THE HORN	LOC
GANKOVSKIY	PER.IND
THAI	GPE.SPECIAL
GUAM	GPE.SPECIAL
SAN JOSE	GPE.SPECIAL
CARTER	PER.IND
AHRAM	ORG.COM
ICFTU	NONE
SENEGAL 'S	GPE.NATION
SENIOR GOVERNMENT OFFICIALS	PER.GROUP
HEAP	PER.IND
RAMGOOLAM	PER.IND
PLO	ORG.NGO
THE ISLAND	GPE.SPECIAL
LDP	NONE
NORTH KOREAN	GPE.SPECIAL
KINGSTON	GPE.SPECIAL
WHITES	PER.GROUP
THE GENERAL ASSEMBLY	NONE
DAOUD 'S	PER.IND
HAMDI	PER.IND
PARIS	GPE.SPECIAL
THE TURKISH GOVERNMENT	GPE.NATION
FINMIN	ORG.GOV
SECSTATE	PER.IND
CITY OF MANILA	NONE
THE COMMISSION 'S	ORG.GOV
ISRAEL	GPE.SPECIAL
AMERICANS	GPE.SPECIAL
THEY	LOC
POLISH	GPE.NATION
THE DEPARTMENT	ORG.GOV
OPEC	ORG.MED
SAUDIS	GPE.NATION
DONNELLY	NONE
PASOK DEPUTIES	PER.GROUP
SHARM EL - SHEIKH	NONE
WALDHEIM	PER.IND
YEMEN	GPE.SPECIAL
TENNESSEE	LOC
HONOLULU	GPE.SPECIAL
HOUGHTON	PER.IND
OXMAN	PER.IND
MWANGI	PER.IND
SECRETARY GENERAL GAJA	PER.IND
JCP	ORG.NGO
BOGOTA	GPE.SPECIAL
THEM	ORG.GOV
DAYAN 'S	PER.IND
PARTY	ORG.NGO
THE PHILIPPINES	NONE
MAURITIUS	NONE
THE GOC	GPE.NATION
THE GOB	GPE.NATION
KENNEDY - MINOTT	PER.IND
THE WEST	LOC
SINAI	LOC
NLP	ORG.NGO
THE GOI	GPE.NATION
DEPT	ORG.GOV
UK DEL	ORG.GOV
DAOUD	PER.IND
JORDAN	GPE.NATION
NORWEGIANS	GPE.NATION
ORIT	ORG.GOV
ADEFOPE	NONE
DUTCH	GPE.NATION
OPPOSITION POLITICIANS	PER.GROUP
KALODJERA	PER.IND
JAPANESE	GPE.SPECIAL
FONMIN KAMEL	NONE
ASEAN	ORG.MED
CZECHOSLOVAKIA	GPE.NATION
CONOFF	PER.IND
PRC	GPE.NATION
PEOPLE 'S ASSEMBLY	ORG.GOV
PRG	ORG.NGO
TURKEY	NONE
CONOCO	ORG.COM
LOWER SAXONY	LOC
ANTARCTIC	LOC
ATHERTON	PER.IND
KYOTO	GPE.SPECIAL
LAGOS	GPE.SPECIAL
COCOM	NONE
THE DUTCH	GPE.NATION
THE PALESTINIANS	GPE.SPECIAL
TORRIJOS '	PER.IND
SCAR	ORG.NGO
BRITISH ANTARCTIC SURVEY	NONE
BERGUS	PER.IND
AMBASSADOR 'S	NONE
FINMIN 'S	PER.IND
CHRISTOPHER	NONE
GULF	ORG.COM
SADAT	PER.IND
THE OFFICE OF THE PRESIDENT	ORG.GOV
CHINATEX	ORG.COM
RHODESIA	GPE.SPECIAL
ISRAELI	GPE.NATION
BENYEI	PER.IND
CHINA	GPE.NATION
THE NAP	ORG.NGO
THE NAM	ORG.GOV
BRUCE	PER.IND
THE PRESIDENT 'S	PER.IND
HER	PER.IND
FAO	ORG.MED
CYPRUS	GPE.SPECIAL
MRS. VLACHOU	PER.IND
KRATTER	PER.IND
THE SWEDISH SHIPOWNERS ASSOCIATION	ORG.COM
CAPITAL	GPE.SPECIAL
ABDUL MAJID	PER.IND
BHUTTO 'S	PER.IND
PANSA	PER.IND
NRP	ORG.NGO
AUSTRIA	GPE.NATION
ROWLANDS '	PER.IND
NICARAGUA	GPE.SPECIAL
BREZHNEV 'S	PER.IND
MANILA	LOC
FORMIN	PER.IND
THE ROK	GPE.SPECIAL
PRAGUE	GPE.SPECIAL
NSC	ORG.GOV
INKOBROD	NONE
BOTHA	PER.IND
DENKTASH 'S	PER.IND
BERLIN	GPE.SPECIAL
MILITARY	ORG.GOV
TASHKENT	GPE.SPECIAL
LOU	NONE
FCO	ORG.GOV
AMBASSADOR WHITE	PER.IND
FOURIE	PER.IND
NORWEGIAN	GPE.NATION
NKOMO	PER.IND
ROGERS	PER.IND
MOSCOW	GPE.NATION
FDA	NONE
EILTS	PER.IND
KELLOGG	ORG.COM
THE OFFICE OF THE PRESIDENT - FOUNDER	ORG.GOV
ITALIAN	GPE.NATION
SMITH	PER.IND
PRESIDENT KORUTURK	NONE
SWEDEN	GPE.SPECIAL
PRIMIN	PER.IND
PETREE	NONE
SINGAPORE	GPE.SPECIAL
PARENT COMPANY	ORG.COM
HIM	PER.IND
WASHDC	GPE.SPECIAL
DENMARK	GPE.NATION
THE LAO	GPE.NATION
HIS	PER.IND
ROMANIAN	GPE.SPECIAL
GOCR	GPE.NATION
URQUHART	PER.IND
THE INDIAN OCEAN	LOC
SWEDES	GPE.NATION
PEKING	GPE.NATION
MEXICAN	GPE.NATION
THE GOVERNMENT	GPE.NATION
MEXICO 'S CTM GENERAL SECRETARY FIDEL VELASQUEZ	PER.IND
CENTRAL AMERICAN	LOC
DEPARTMENT 'S	ORG.GOV
THE ITALIANS	GPE.NATION
PHILIPPINES	GPE.NATION
SAIGON	GPE.SPECIAL
THE EMBASSY	ORG.GOV
WHO	NONE
UNIONIST	PER.GROUP
AS SIYASA	ORG.COM
DCM	PER.IND
CHAIRMAN	PER.IND
HAWKINS	PER.IND
MEXICANS	GPE.NATION
DENKTASH	PER.IND
ZIGDIS	PER.IND
HONG KONG	NONE
ITALY 'S	NONE
THE LDP	NONE
WP - 6	PER.GROUP
HERE	GPE.SPECIAL
KIRSTEN	PER.IND
PORT LOUIS	NONE
EGYPT	NONE
JAPAN	GPE.SPECIAL
CFA DELS	PER.GROUP
SKAFF	PER.IND
EGYPTIAN	GPE.NATION
HMG	GPE.NATION
MISSION	ORG.GOV
NORWAY	GPE.SPECIAL
DJAMIRIN	NONE
SOUTH AFRICAN	GPE.NATION
ALGIERS	GPE.SPECIAL
MEXICO	GPE.NATION
AMERICAN	GPE.SPECIAL
THE PNA	ORG.NGO
YEMENIS	GPE.SPECIAL
INGENIORSFIRMAN FLIESBERG AB HARTIG FLIESBERG FORETAGEN AB	PER.GROUP
HAIG	PER.IND
MINFIN	ORG.GOV
THEMSELVES	PER.GROUP
YOU	ORG.GOV
DFA	ORG.GOV
